1111111111111111111111111111111111111
1C00000000000000000000000000000000001
1111111111111111100000000000000000001
1000000000000011100000000000001110001
100000000001000C100000000000001000111
1000011111111111100000000000001110001
1000000000000000100000000000001000001
1000000000000000000000000000001000001
1000000000000000111111111111111000001
1000000C000000001C0000000000000010001
10000000000000011111111000000000100C1
1000000000000001111111111111111111111
10000C0000000000000000000000000000001
1000000000000000000000000000000000001
1000000000000000000000000000000000001
1000000000000000000000000000000000001
1111111111111111100000000000000000001
1000000000000011100000000000001110001
100000000001000C100000000000001000111
1000011111111111100000000000001110001
1000000000000000100000000000001000001
1000000000000000000000000000001000001
1000000000000000111111111111111000001
1000000C000000001C0000000000000010001
10000000000000011111111000000000100C1
1000000000000001111111111111111111111
10000C0000000000000000000000000000001
1000000000000000000000000000000000001
1000000000000000000000000000000000001
1000000000000000000000000000000000001
1111111111111111100000000000000000001
1000000000000011100000000000001110001
10000000000100EC100000000000001000111
1000011111111111100000000000001110001
1000000000000000100000000000001000001
1000000000000000000000000000001000001
10P0000000000000111111111111111000001
1000000C000000001C0000000000000010001
10000000000000011111111000000000100C1
1111111111111111111111111111111111111
